# PLEASE!
alias please='sudo'

# Updater & Cleaner
alias updater='sudo apt-get update && sudo apt-get -y upgrade && sudo apt-get -y dist-upgrade && sudo snap refresh'
alias cleaner='sudo apt-get clean && sudo apt-get autoclean && sudo apt-get autoremove'

# fastfetch
alias ff='fastfetch'

# QOL
alias cd..='cd ..'
alias grep='grep --color=auto'
alias rm='rm -I --preserve-root'
alias chown='chown --preserve-root'
alias chmod='chmod --preserve-root'
alias chgrp='chgrp --preserve-root'
alias wget='wget -c'
alias systemctl='sudo systemctl'
alias home='cd ~'
alias untar='tar -xvf'
alias mktar='tar -cvf'

# Remove a directory and all files
alias rmd='rm  --recursive --force --verbose '

#Edit this file
alias ba='nano ~/.bash_aliases'

# Alias's for safe and forced reboots
alias rebootsafe='sudo shutdown -r now'
alias rebootforce='sudo shutdown -r -n now'

# youtube-dl
alias yta-aac='yt-dlp --extract-audio --audio-format aac '
alias yta-best='yt-dlp --extract-audio --audio-format best '
alias yta-flac='yt-dlp --extract-audio --audio-format flac '
alias yta-m4a='yt-dlp --extract-audio --audio-format m4a '
alias yta-mp3='yt-dlp --extract-audio --audio-format mp3 '
alias yta-opus='yt-dlp --extract-audio --audio-format opus '
alias yta-vorbis='yt-dlp --extract-audio --audio-format vorbis '
alias yta-wav='yt-dlp --extract-audio --audio-format wav '
alias ytv-best='yt-dlp -f bestvideo bestaudio '

# GIT
alias gs='git status'
alias ga='git add'
alias gaa='git add --all'
alias gp='git push'
alias gc='git commit'
alias gb='git checkout -b' # Create a new Git branch and move to the new branch at the same time
alias gd='git diff'
